0000 0000 0000 0000 0000 0000 0000 0000 0000 0000 0000 0000 0000 0000 0000 0000 0000 0000 0000 0000 0000 0000 0000 0000 0000 0000 0000 0000 0000 0000
0000 0000 0000 0000 0000 0000 0000 0000 0000 0000 0000 0000 0000 0000 0000 0000 0000 0000 0000 0000 0000 0000 0000 0000 0000 0000 0000 0000 0000 0000
0000 0000 0000 0000 0000 0000 0000 0000 0000 0000 0000 0000 0000 0000 0000 0000 0000 0000 0000 0000 0000 0000 0000 0000 0000 0000 0000 0000 0000 0000
0000 0000 0000 0000 0000 0000 0000 0000 0000 0000 0000 0000 0000 0000 0000 0000 0000 0000 0000 0000 0000 0000 0000 0000 0000 0000 0000 0000 0000 0000
0000 0000 0000 0000 0000 0000 0000 0000 0000 0000 0000 0000 0000 0000 0000 0000 0000 0000 0000 0000 0000 0000 0000 0000 0000 0000 0000 0000 0000 0000
0000 0000 0000 0000 0000 0000 0000 0000 0000 0000 0000 0000 0000 0000 0000 0000 0000 0000 0000 0000 0000 0000 0000 0000 0000 0000 0000 0000 0000 0000
0000 0000 0000 0000 0000 0000 0000 0000 0000 0000 0000 0000 0000 0000 0000 0000 0000 0000 0000 0000 0000 0000 0000 0000 0000 0000 0000 0000 0000 0000
0000 0000 0000 0000 0000 0000 0000 0000 0000 0000 0000 0000 0000 0000 0000 0000 0000 0000 0000 0000 0000 0000 0000 0000 0000 0000 0000 0000 0000 0000
0000 0000 0000 0000 0000 0000 0000 0000 0000 0000 0000 0000 0000 0000 0000 0000 0000 0000 0000 0000 0000 0000 0000 0000 0000 0000 0000 0000 0000 0000
0000 0000 0000 0000 0000 0000 0000 0000 0000 0000 0000 0000 0000 0000 0000 0000 0000 0000 0000 0000 0000 0000 0000 0000 0000 0000 0000 0000 0000 0000
0000 0000 0000 0000 0000 0000 0000 0000 0000 0000 0000 0000 0000 0000 0000 0000 0000 0000 0000 0000 0000 0000 0000 0000 0000 0000 0000 0000 0000 0000
0000 0000 0000 0000 0000 0000 0000 0000 0000 0000 0000 0000 0000 0000 0000 0000 0000 0000 0000 0000 0000 0000 0000 0000 0000 0000 0000 0000 0000 0000
0000 0000 0000 0000 0000 0000 0000 0000 0000 0000 0000 0000 0000 0000 0000 0000 0000 0000 0000 0000 0000 0000 0000 0000 0000 0000 0000 0000 0000 0000
0019 0019 0019 0019 0000 0000 0000 0000 0000 0000 0000 0000 0000 0000 0000 0000 0000 0000 0000 0000 0000 0000 0000 0000 0000 0000 0000 0000 0000 0000
0000 000f 0000 0000 0014 0013 0013 0013 0013 0013 0013 0013 0013 0013 0013 0013 0013 0013 0013 0013 0013 0013 0013 0015 0010 0011 0000 0000 0000 0000
0000 000f 0000 0000 0000 0000 0000 0000 0000 0000 0000 0000 0000 0000 0000 0000 0000 0000 0000 0000 0000 0000 0000 0000 000f 0003 0000 0000 0000 0000
0019 0019 0019 0019 0019 0000 0000 0000 0000 0000 0000 0000 0000 0000 0000 0000 0000 0000 0000 0000 0000 0000 0000 0000 000f 0003 0000 0000 0000 0000
0000 000f 0000 0000 0000 0000 0000 0000 0000 0000 0000 0000 0000 0000 0000 0000 0000 0000 0000 0000 0000 0000 0000 0000 000f 0003 0000 0000 0000 0000
0000 000f 0000 0000 0000 0000 0000 0000 0000 0000 0000 0000 0000 0000 0000 0000 0000 0000 0000 0000 0000 0000 0000 0000 000f 0003 0000 0000 0000 0000
0019 0019 0019 0019 0019 0019 0019 0019 0000 0000 0000 0000 0007 0006 0009 0000 0000 0000 0000 0000 0000 0000 0000 0000 000f 0003 0000 0000 0000 0000
0000 0000 0000 0000 0000 0000 0000 0000 0000 0000 0000 0000 0004 0003 0003 0000 0000 0000 0000 0000 0000 0000 0000 0000 000f 0003 0000 0000 0000 0000
0000 0000 0000 0000 0000 0000 0000 0000 0000 0000 0000 0000 0004 0003 0003 0000 0000 0000 0000 0000 0000 0000 0001 0000 000f 0003 0000 0000 0000 0000
0000 0000 0000 0000 0000 0000 0000 0000 0000 0000 0000 0000 0004 0011 0003 0000 0000 0000 0000 0000 0019 0019 0019 0019 0019 0019 0019 0019 0019 0019
0000 0000 0000 0000 0000 0000 0000 0000 0000 0000 0000 0000 0004 0003 0003 0000 0000 0000 0000 0000 0000 0000 0000 0000 0010 0011 0000 0000 0000 0000
0000 0000 0000 0000 0000 0000 0000 0000 0000 0000 0000 0000 0004 0003 0003 0000 0000 0000 0000 0000 0000 0000 0000 0000 000f 0003 0000 0000 0000 0000
0006 0006 0006 0006 0000 0000 0000 0000 0000 0000 0000 0000 0004 0003 0003 0000 0000 0000 0000 0000 0000 0000 0000 0000 000f 0003 0000 0000 0000 0000
0003 0003 0011 0003 0017 0016 0018 0006 0006 0006 0000 0000 0010 0003 0003 0019 0019 0019 0019 0019 0019 0019 0019 0019 0019 0019 0019 0019 0019 0019
0003 0003 0003 0003 0000 0000 0000 0004 0003 0003 0000 0000 0004 0003 0003 0000 0000 0000 0000 0000 0000 0000 0000 0000 0010 0011 0000 0000 0000 0000
0003 0011 0003 0003 0000 0000 0000 0004 0011 0003 0000 0000 0004 0003 0003 0000 0000 0000 0000 0000 0000 0000 0000 0000 000f 0003 0000 0000 0000 0000
0003 0003 0003 0003 0000 0000 0000 0004 0003 0003 0000 0000 0004 0003 0003 0000 0000 0000 0000 0000 0000 0000 0000 0000 000f 0003 0000 0000 0000 0000